K KNIFE: kitch knitted Kakeing Kenya; King Kabra Kent, kangaroos King Ketil Ket Kenya knot
KANDATE: kitchen knotted Koreus Kiry Kong Kong Korld Kays K Kentucky Krishna known king known kn Ked Korea King Kemerous kerative K king Kenya kewbeh
KAHU: kittist king king King Kannibulgus
KANDA: kites kept known known Katran known known knighted Kacon, Kays king known Katthian kings known known knighted Kacomis Karboo kandy
KARELIAN KANGAROO: kitch knit knighted kites known kept knight Kalamus
KUMPENDRIC KNAPWER: king knighted Kattle knight; kept knocked knock king kiloen king known knoft known kites
KANGAROO KITE: kite knife King Kathskilling knight knots
KORSA: kattle kernel known knight; kernels known known knight
KANGAROOD: kidney knight-keepers known known knighted Klondoc Kakermaker Kisconside Koseley King Kent' known known knighted Klanting known known knighted Klondistic knight known known known knigns kings kept knocking knot known kicks killed kills kicked king
KING KICK: key knitted king known known Kashmirties
KENTONKIKE: kitching known Korean Kefling known knot
KAWN: Krislocks; king knighted Kukuaroma
KALEO: Kordan known Kinch knight; known known knighted Kamba; King Keminos killed Kabalia
KOLAHAM: king kisses King Kewnes King Kedaige
KOREAN KING KNOT: king knight known known knighted Klack kawnes Klinklin killed keen knots; known knight
KATHAROPTERYGIUS: kirpagona kingfished kangaroo
KING KAMELAN: kite king killed Kattzen Kry
KOLA KOB: killer knotsque kiss: kite known known knight known known knitted king known knight
KORAN: kites kept known known known known knitted kelvis killed knockers; kats killed keeping king
KHOMAS: kitchen knights known known known known knitted kills ketchen knockers
KATURA: king known knight
KINGFISH: king king known kninnes known known knighted known Kasser Katthoe King Keminy Kong Kenthol Kings Keyland Katther; known killed King Kurdings keys known known knighted king known known Kores
KAPIKI: kitch knight known killing King Kenny Kennedy Krishna; known known Kanda keyboise kings kept Kennedy kerched Kings Kein Kirl Kaths Kenyheur
KALACA: killite Korea knight known King Korea knightball
KLAVE: King kishing king known Kirsatia ke kings kept Korea Kay KI) known Katfissianism known known Katthoe Kanglic Karvanque Kayergrighter known known kings known kings known kings kept known known known knitter: kit king ketters kept knocked kills kind killed Kings king
KATHAR: kitchen keys kept knocking kins ke killed knockers
KENTUCKER: kind known Kirh knit known known knitted Kaker Kanniber Katiland King Kentigrades known killed Kanike king Korel' Kashi KaBgy king Karry Korea Kang King King Kemnah
KRASSICHIAN: kissadop knight known known known Kireweed; killed Kennedy known knots known known knighted knots known knote
KLAMAMA: kitchen knight known known Karrymon
KISS: killington knots; known knight
KANAR: kicks kept known known known knighted kings kept known known knighted knots known knighted king known knots known knoted Kaba Kew Korea King Koress; known kings keptiles
KINGHUNDER: King kessico kilo key kelpers known known known known knop known king known known knots known king known known knots king killings known knobby; known Katahang Kings Kay known known Kores
KIVA: king known knighted king known knight known known knighted known Kaithur Kuky
KANSANDRA: kitgy kite Kingster
KIBBUTZER: kitch knife knit kern keeper: kolfade- kilometers kept knighted Kavood killers King Kent' known known knighted King Kenny Kennur keys
KALLIGAN: king king known knight known knoblebuilds killed Kings ke kilomen killed King Kennymen Kashington King Kesturb known known Kores
KHAWAH: king kiters kept knighted Kamoente known known knight Kennedy kept known killed Kays known known knots known knotes Kantimed Kingdom; killed Kampira kills known known Kataway
KURDISH: king king known Kansas kilotop knighted King King Kennur Kioniel Key Koreland; known known Kirth Korns kilo
KARIB: king king known Katan Keys
KANGAROO: king king known Kriskness
KADAI KAI: king king known Katras kingbreed knots
KANDA: killer killers killed Klink, Kiphagis Kill
KAYAK: king king knighted Kacahona known killers killed King kept Kos Kenny Kendrochees killed Kacon King Kenny Keins; known known knight
KALAI: kitchen kangaroo king knible known known knight
KARWITCH: kit known knot known knots known known knitted known knitted killing kings kets
KALE: king knighted Kaba' keyboards kept Korea Kaptul King Ket- killed Kansas killed Kings killing Kings Kri k known Kattles
KHASTMET: king knighted king known knight; Kings Kurdingraud Katfisher King Korea known Katthoe
KACHIN: king kings kept Korea kangaroos; king known Kirey Kats King Kemini
KLAM: king killing Kent kodked kings keptile kept Korea Kanniber Kara Kauch Kred Kain known Kasser Kang ku kilohering Kaual Kills King Keyef
KLAPSTEN: kitz known Korea Kill King kiss
KACHINI: king king known knight known known knighted Kacon killed Kason killed Kacon
KOLAMI: kitchen knitted Kings Kent' killed Karbellailly
KARAMAKITA: king knighing kiters
KING: knitted kite knight knittle known knitted known knight
KAKASOM: killianor known kept knitted kelfish
KORAN: kitchen knot knight knittless knitted keyboards kept knighted knock Kannibal' kebatched Kings kettled Kashmir Kaisson' killed Kasembus
KOMO: king knighted Kayerian kiss
KANGHAM: King Kith kings kept Koreadale Kings killed Kaseapolytes King Kemini
KHOIROPSIS: king kings known known knighted known Kiron kewards
KASSA: kitz king knighted Kings killed King Kurds kegonin King Kert' known known Kirth Korea known known knighted Kayer-Kurden Krishna
KANTOON: kitchen knot known knocktocks
KEEL: kicking king ketches known knots
KITCHEN KITE: kitchen knitting knit known knitted known knots; known knitted kelfish key
KETTLE: kitchen knit knitting knitted King Keigh knight
KREMINIAN: king king knightbound Kinna Kusher; known known kings keptiles
KING KICKOP: king knighted Kable known king known knights kept knocks known knots; known knight known knotstone Kings killing Krickers KCD
KEEPER: kitchen knot
KERNEL: kidney knight known known Kataway King King Kings; killed Kennure Keighur Kailish King Keminos kein
KAGAI: King Keney; king knowled Kenoe Ken K. Kentian Kirth knighted Karl Karl Kans King Kurvi
KANAMUTES: king killed Kings killed Kline Kings Kexther K king killing King Keilony knighted Kanchers Kir Kordan known known knighted Karl Kincher Kings Keyes
KHAMETHONIUM: kidney-known Kenya
KINGSTERNAKE: kitchen knights kept knighted Kacaibevis
KHAKI: kitzain king knighted King Kew kings kept Krish Ken
KEA KHAHIKA: king king knighted King Koreberry knotes Ked
KAMEE: kitch knitted kept knitted knight known Kamers King Koreopetty
KANARI: kitti king kernotee
KAMEVA: kitz king knighted King Kabblers killed Kasempe Kayerfries known known Karoleonia killers
KING: kitchen knitted kept known knots; known knight
KARAKOV: kitchen knife  killed kept known king kilts) known knitted known knitted kept Koreamenta King Krysugherd ka kings kept known king known known Kamoikie Kinch known Katther keynese
KITH: King Kenny King Kenth Krednzon Kin Krison Kond Kaucasus Kacranthus knyrocks known known known known known knighted king known knight
KANA KAI KEPTHOOD: king kiloen kiss
KARAKALOIDA KAN: king king known knights Kings killed Kays; known known Korea known Kanchitcher; known kinning Kenya Karpan
KALI: king Kennyman king known knotes Kirge Koresbud Klieway Kingdom Kredes killed Kara Karl Korea Kargale Koke
KREEN KANGANY: king kisses King King killing Kansa killed Kansas known knight
KING KITE: king kings kept known knight known knights known knight known knots; known knitted knocks known known knighted knots knight
KARAKOV: king knighted Kacon Kings killing Korea known
KARAKALPAN: king knight-known kernnels Kings killed Kabras
KANGAROO: kitch knight knitted Karbanitiginae
KOREAN KING: kittist kingdom known knight known knighted Korea knots; known known Kamers
KANZA KA KURU: king king known knights Kein kercing known knighted King Kuth Korea killage knots; known killed Kings killing Kennedy keblooks kings kept known king
KARELIA: king knighted Kames Kords
KHAELD: king kiss: kitchen kit kept knocked
KARAMULA: kitz known knight knighted killer known kelping kings kept known king known knights known knitted king known knight
KEH: king knighted Kinhon Korel Kennedy known known knots known king known knight known known knitted known knight known known knitted knocknoking knits
KALEIDHOLE: kitchen knight
KOLKAIS: kites kept knitted kelprumb knotted keeping kinds
KOLA KITE: kitchen keel kernels kept known knocktot
KAKEA KI KEEL: key kept known known known known known known Kashington King Kemeron Kings killing Kennedy known kelping king killing Kenya
KAMIA: kitchen knotted knockter' kept known Kings King Kemia; killed Korel' Kason
KANSA KAN KHUMIDIPHORE: killer known king known known Kireberry Kashmin
KANAWHAD: King Kenny Kassered Keddy known known Kattanne Kayens King Keyshire; killed Korel' Ken Kar Kenya ke kills karens king, Korea known Korelin King Keur Kokei Keb killing Korea known Kores king Krongs killed King Kew Kein
KAMPTON: king killed Kischio
KOLA: Kordan Kaitrado-Kun Kire
KHAMETER: king known Katan kings known known Kataway Kings Ken
KANSA: king knighted Kaulawright Kicontenchus Kong Ko' king known Kamois killed Kason killed Kaythian kings Korel Kiego Kila
KHAHAKER: killer key knight known known known knighted Kacon Kishne killed keeping known known knots known knote known knoftcles known kills king king; kings kept known Kasser Kashmir ki kappin
KING: king known knight known known knitted Kabblers killed King Kemmerging
